###################
#S      ###      ##
# ### #      # # ##
# #     # # #  #  #
# #####   #  # ## #
#   #   # # #     #
### # ### # # # ###
#           #    E#
###################